gene	node_type
SPTR	gene
PU	gene
PR	gene
SPTR	PPI
PU	PPI
PR	PPI
ATL	PPI
MXT	PPI
CATSUP	PPI
DRONGO	PPI
BACC	PPI
CG6279	PPI
JAFRAC2	PPI
GRSM	PPI
TTD14	PPI
PEZ	PPI
AHCYL1	PPI
MAPMODULIN	PPI
GRK	PPI
TPI	PPI
BSK	PPI
